. * * * . . . 
. . . . . . * 
* . . . . * . 
. . . * * . * 
* . . . * . . 
. . . . . . . 
. . . . . . . 